
Plugin	Supported domains
abv	@abv.bg, @gyuvetch.bg, @gbg.bg
aggregator	@aggregator, @...
alice.lua*	@alice.it
ananzi.lua*	@ananzi.co.za, @...
aol	@aol.com, @aol.com.ar, @aol.fr, @aol.com.mx, @aol.com.au, @aol.de, @aol.com.pr, @aol.com.br, @jp.aol.com, @aol.com.uk, @aol.ca, @aola.com, @aim.com
arabia.lua*	@arabia.com, @algeriamail.com, @bahrainmail.com, @cairomail.com, @desertmail.com, @dubaimail.com, @iraqmail.com, @jerusalem-mail.com, @jordanmail.com, @kuwait-mail.com, @lebanonmail.com, @libyamail.com, @moroccomail.com, @omanmail.com, @palestinemail.com, @qatarmail.com, @qudsmail.com, @saudi-mail.com, @sudanmail.com, @syriamail.com, @tunisiamail.com, @uaemail.com, @yemenmail.com
aruba.lua*	@aruba.it
ciaoweb.lua*	@ciaoweb.it
davmail	@lycos.co.uk, @lycos.ch, @lycos.de, @lycos.es, @lycos.it, @lycos.at, @lycos.nl, @spray.se, @jubii.dk
elitel.lua*	@lombardiacom.it, @postino.it
excite	@excite.com, @myway.com
excitexml.lua*	@excite.com, @myway.com
fastmail	@123mail.org, @150mail.com, @150ml.com, @16mail.com, @2-mail.com, @4email.net, @50mail.com, @airpost.net, @allmail.net, @bestmail.us, @cluemail.com, @elitemail.org, @emailgroups.net, @emailplus.org, @emailuser.net, @eml.cc, @fastem.com, @fast-email.com, @fastemail.us, @fastemailer.com, @fastest.cc, @fastimap.com, @fastmail.cn, @fastmail.com.au, @fastmail.fm, @fastmail.us, @fastmail.co.uk, @fastmail.to, @fmail.co.uk, @fast-mail.org, @fastmailbox.net, @fastmessaging.com, @fea.st, @f-m.fm, @fmailbox.com, @fmgirl.com, @fmguy.com, @ftml.net, @hailmail.net, @imap.cc, @imap-mail.com, @imapmail.org, @internet-e-mail.com, @internetemails.net, @internet-mail.org, @internetmailing.net, @jetemail.net, @justemail.net, @letterboxes.org, @mailandftp.com, @mailas.com, @mailbolt.com, @mailc.net, @mailcan.com, @mail-central.com, @mailforce.net, @mailftp.com, @mailhaven.com, @mailingaddress.org, @mailite.com, @mailmight.com, @mailnew.com, @mail-page.com, @mailsent.net, @mailservice.ms, @mailup.net, @mailworks.org, @ml1.net, @mm.st, @myfastmail.com, @mymacmail.com, @nospammail.net, @ownmail.net, @petml.com, @postinbox.com, @postpro.net, @proinbox.com, @promessage.com, @realemail.net, @reallyfast.biz, @reallyfast.info, @rushpost.com, @sent.as, @sent.at, @sent.com, @speedpost.net, @speedymail.org, @ssl-mail.com, @swift-mail.com, @the-fastest.net, @theinternetemail.com, @the-quickest.com, @veryfast.biz, @veryspeedy.net, @warpmail.net, @xsmail.com, @yepmail.net, @your-mail.com
flatnuke	@flatnuke, @...
foo	@..., @...
gmail	@gmail.com
hotmail	@hotmail.com, @msn.com, @webtv.com, @charter.com, @compaq.net, @passport.com, @hotmail.de, @hotmail.it, @hotmail.co.uk, @hotmail.co.jp, @hotmail.fr, @messengeruser.com, @hotmail.com.ar, @hotmail.co.th, @hotmail.com.tr, @windowslive.com, @milanosemplice.it
imp.lua*	@imp, @inf.utfsm.cl, @alumnos.inf.utfsm.cl, @f2s.com, @free.fr, @...
inbox.lua*	@212.com, @aah.net, @adios.net, @allalone.com, @asm.net, @backwards.com, @blink182.net, @bombdiggity.com, @bonzo.com, @bounce.net, @bounty.net, @breakbeat.com, @brigid.com, @broken.org, @businessman.net, @businesswoman.net, @c4.org, @captain.net, @chatonline.com, @cindy.org, @cookiemonster.com, @cps.org, @danger.org, @dangerous.net, @davis.org, @deadman.com, @devoid.org, @discover.org, @dnb.net, @donjuan.com, @dragonballz.net, @drug.org, @duet.net, @elmer.com, @explorer.org, @five.net, @freshman.net, @friction.net, @geography.net, @highquality.com, @hurting.com, @hut.net, @i386.net, @inbox.net, @insecure.net, @intimate.net, @javascript.org, @kermit.net, @kernel.net, @lab.org, @lakmail.com, @lauren.net, @leanne.com, @lebaron.com, @lemonheads.com, @limpbizkit.net, @melt.com, @meth.com, @misery.net, @myst.net, @negative.org, @netromance.com, @nill.net, @nix.org, @nocturnal.com, @outerlimits.net, @penguins.org, @pez.net, @phantom.org, @playtime.org, @punks.net, @revert.com, @roms.net, @sad.net, @scared.org, @sedate.com, @simpsons.com, @skating.net, @slayer.org, @so.org, @sof.net, @sparcs.com, @stallion.net, @stigmata.com, @strangers.com, @stullers.com, @theunknown.com, @twinkie.com, @typo.net, @vga.net, @vrv.com, @ys.com
juno	@netzero.net, @netzero.com, @juno.com
kernel	@kernel.org, @kernel.org.24, @kernel.org.26
libero	@libero.it, @inwind.it, @iol.it, @blu.it
logonsw.lua*	@logonsw.it
lycos	@...
mail2world	@mail2*.com
mailcom	@mail.com, @email.com, @iname.com, @cheerful.com, @consultant.com, @europe.com, @mindless.com, @earthling.net, @myself.com, @post.com, @techie.com, @usa.com, @writeme.com, @2die4.com, @artlover.com, @bikerider.com, @catlover.com, @cliffhanger.com, @cutey.com, @doglover.com, @gardener.com, @hot-shot.com, @inorbit.com, @loveable.com, @mad.scientist.com, @playful.com, @poetic.com, @popstar.com, @popstarmail.org, @saintly.com, @seductive.com, @soon.com, @whoever.com, @winning.com, @witty.com, @yours.com, @africamail.com, @arcticmail.com, @asia.com, @australiamail.com, @europe.com, @japan.com, @samerica.com, @usa.com, @berlin.com, @dublin.com, @london.com, @madrid.com, @moscowmail.com, @munich.com, @nycmail.com, @paris.com, @rome.com, @sanfranmail.com, @singapore.com, @tokyo.com, @accountant.com, @adexec.com, @allergist.com, @alumnidirector.com, @archaeologist.com, @chemist.com, @clerk.com, @columnist.com, @comic.com, @consultant.com, @counsellor.com, @deliveryman.com, @diplomats.com, @doctor.com, @dr.com, @engineer.com, @execs.com, @financier.com, @geologist.com, @graphic-designer.com, @hairdresser.net, @insurer.com, @journalist.com, @lawyer.com, @legislator.com, @lobbyist.com, @minister.com, @musician.org, @optician.com, @pediatrician.com, @presidency.com, @priest.com, @programmer.net, @publicist.com, @realtyagent.com, @registerednurses.com, @repairman.com, @representative.com, @rescueteam.com, @scientist.com, @sociologist.com, @teacher.com, @techie.com, @technologist.com, @umpire.com, @02.to, @111.ac, @123post.com, @168city.com, @2friend.com, @65.to, @852.to, @86.to, @886.to, @aaronkwok.net, @acmilan-mail.com, @allstarstats.com, @amrer.net, @amuro.net, @amuromail.com, @anfieldroad-mail.com, @arigatoo.net, @arsenal-mail.com, @barca-mail.com, @baseball-mail.com, @basketball-mail.com, @bayern-munchen.com, @birmingham-mail.com, @blackburn-mail.com, @bsdmail.com, @bsdmail.org, @c-palace.com, @celtic-mail.com, @charlton-mail.com, @chelsea-mail.com, @china139.com, @chinabyte.com, @chinahot.net, @chinarichholdings.com, @coolmail.ac, @coventry-mail.com, @cseek.com, @cutemail.ac, @daydiary.com, @dbzmail.com, @derby-mail.com, @dhsmail.org, @dokodemo.ac, @doomo.net, @doramail.com, @e-office.ac, @e-yubin.com, @eracle.com, @eu-mail.net, @everton-mail.com, @eyah.com, @ezagenda.com, @fastermail.com, @femail.ac, @fiorentina-mail.com, @football-mail.com, @forest-mail.com, @freeid.net, @fulham-mail.com, @gaywiredmail.com, @genkimail.com, @gigileung.org, @glay.org, @globalcom.ac, @golf-mail.com, @graffiti.net, @gravity.com.au, @hackermail.com, @highbury-mail.com, @hitechweekly.com, @hkis.org, @hkmag.com, @hkomail.com, @hockey-mail.com, @hollywood-mail.com, @ii-mail.com, @iname.ru, @inboexes.org, @inboxes.com, @inboxes.net, @inboxes.org, @insingapore.com, @intermilan-mail.com, @ipswich-mail.com, @isleuthmail.com, @jane.com.tw, @japan1.org, @japanet.ac, @japanmail.com, @jayde.com, @jcom.ac, @jedimail.com, @joinme.com, @joyo.com, @jpn1.com, @jpol.net, @jpopmail.com, @juve-mail.com, @juventus-mail.com, @juventusmail.net, @kakkoii.net, @kawaiimail.com, @kellychen.com, @keromail.com, @kichimail.com, @kitty.cc, @kittymail.com, @kittymail.net, @lazio-mail.com, @lazypig.net, @leeds-mail.com, @leicester-mail.com, @leonlai.net, @linuxmail.org, @liverpool-mail.com, @luvplanet.net, @mailasia.com, @mailjp.net, @mailpanda.com, @mailunion.com, @man-city.com, @manu-mail.com, @marchmail.com, @markguide.com, @maxplanet.com, @megacity.com, @middlesbrough-mail.com, @miriamyeung.com, @miriamyeung.com.hk, @myoffice.ac, @nctta.org, @netmarketingcentral.com, @nettalk.ac, @newcastle-mail.com, @nihonjin1.com, @nihonmail.com, @norikomail.com, @norwich-mail.com, @old-trafford.com, @operamail.com, @otakumail.com, @outblaze.net, @outgun.com, @pakistans.com, @pokefan.com, @portugalnet.com, @powerasia.com, @qpr-mail.com, @rangers-mail.com, @realmadrid-mail.com, @regards.com, @ronin1.com, @rotoworld.com, @samilan.com, @searcheuropemail.com, @sexymail.ac, @sheff-wednesday.com, @slonline.net, @smapxsmap.net, @southampton-mail.com, @speedmail.ac, @sports-mail.com, @starmate.com, @sunderland-mail.com, @sunmail.ac, @supermail.ac, @supermail.com, @surfmail.ac, @surfy.net, @taiwan.com, @talknet.ac, @teddy.cc, @tennis-mail.com, @tottenham-mail.com, @utsukushii.net, @uymail.com, @villa-mail.com, @webcity.ca, @webmail.lu, @welcomm.ac, @wenxuecity.net, @westham-mail.com, @wimbledon-mail.com, @windrivers.net, @wolves-mail.com, @wongfaye.com, @worldmail.ac, @worldweb.ac, @isleuthmail.com, @x-lab.cc, @xy.com.tw, @yankeeman.com, @yyhmail.com, @verizonmail.com, @lycos.com, @cyberdude.com, @mail.org, @italymail.com, @mexico.com, @india.com, @u2club.com, @royal.net
mailinator.lua*	@mailinator.com, @PutThisInYourSpamDatabase.com, @ThisIsNotMyRealEmail.com, @binkmail.com, @SpamHerePlease.com, @SpamHereLots.com, @SendSpamHere.com, @chogmail.com, @SpamThisPlease.com, @frapmail.com, @obobbo.com, @devnullmail.com, @...
mailmd.lua*	@mail.md
mbox.lua*	@mbox.xx
monitor	@monitor
mycosmos.lua*	@mycosmos.gr
mysinamail.lua*	@mysinamail.com, @sina*.com
netscape	@netscape.net
orange	@fsmail.net, @wanadoo.nl, @orange.nl, @bedrijfsnaam.nl
owa.lua*	@owa
popforward	@...
sei.lua*	@prodesp.sp.gov.br, @sei.sp.gov.br, @daee.sp.gov.br, @serhs.sp.gov.br, @detran.sp.gov.br, @educacao.sp.gov.br, @fazenda.sp.gov.br, @habitacao.sp.gov.br
shecom.lua*	@she.com
skeleton	@..., @...
softhome	@softhome.net
squirrelmail	@...
studivz.lua*	@studivz.de, @studivz.net, @meinvz.de, @meinvz.net, @schuelervz.de, @schuelervz.net
supereva	@supereva.it, @supereva.com, @freemail.it, @freeweb.org, @mybox.it, @superdada.com, @cicciociccio.com, @mp4.it, @dadacasa.com, @clarence.com, @concento.it, @dada.net
tdconline.lua*	@tdconline.dk
tin	@tin.it, @virgilio.it, @alice.it, @tim.it, @atlantide.it
tre	@tre.it, @three.com.au
updater	@updater
yahoo @yahoo.com
